"","sex","entry","exit","time","cens"
"1","Male",782,909,127,1
"2","Male",1020,1128,108,1
"3","Male",856,969,113,1
"4","Male",915,957,42,1
"5","Male",863,983,120,1
"6","Male",906,1012,106,1
"7","Male",955,1055,100,1
"8","Male",943,1025,82,1
"9","Male",943,1043,100,1
"10","Male",837,945,108,1
"11","Male",966,1009,43,1
"12","Male",936,971,35,1
"13","Male",919,1033,114,1
"14","Male",852,869,17,1
"15","Male",1073,1139,66,1
"16","Male",925,1036,111,1
"17","Male",967,1085,118,1
"18","Male",806,943,137,0
"19","Male",969,1001,32,0
"20","Male",923,1060,137,0
"21","Male",865,1002,137,0
"22","Male",953,1031,78,0
"23","Male",871,945,74,0
"24","Male",982,1006,24,0
"25","Male",883,959,76,0
"26","Male",817,843,26,0
"27","Male",875,1012,137,0
"28","Male",821,956,135,0
"29","Male",936,1073,137,0
"30","Male",971,1107,136,0
"31","Male",830,940,110,0
"32","Male",885,911,26,0
"33","Male",894,1031,137,0
"34","Male",893,996,103,0
"35","Male",866,895,29,0
"36","Male",878,1015,137,0
"37","Male",820,957,137,0
"38","Male",1007,1043,36,0
"39","Male",879,1016,137,0
"40","Male",956,1093,137,0
"41","Male",854,989,135,1
"42","Male",890,1027,137,0
"43","Male",1041,1044,3,0
"44","Male",978,1005,27,0
"45","Male",836,973,137,0
"46","Male",938,1064,126,0
"47","Male",886,1023,137,0
"48","Male",876,1013,137,0
"49","Male",955,977,22,0
"50","Male",823,960,137,0
"51","Male",960,1047,87,0
"52","Male",843,943,100,0
"53","Male",856,951,95,0
"54","Male",847,984,137,0
"55","Male",1027,1058,31,0
"56","Male",988,1045,57,0
"57","Male",978,1018,40,0
"58","Male",981,1118,137,0
"59","Male",926,970,44,0
"60","Male",1036,1070,34,0
"61","Male",1016,1153,137,0
"62","Male",969,1106,137,0
"63","Male",900,936,36,0
"64","Male",898,906,8,0
"65","Male",846,866,20,0
"66","Male",964,1029,65,1
"67","Male",984,1053,69,1
"68","Male",1046,1080,34,1
"69","Male",871,872,1,1
"70","Male",847,893,46,1
"71","Male",962,966,4,0
"72","Male",853,894,41,1
"73","Male",967,985,18,1
"74","Male",1063,1094,31,1
"75","Male",856,927,71,1
"76","Male",865,948,83,1
"77","Male",1051,1059,8,1
"78","Male",1010,1012,2,1
"79","Male",878,911,33,1
"80","Male",1021,1094,73,1
"81","Male",959,972,13,0
"82","Male",921,993,72,1
"83","Male",836,876,40,1
"84","Male",919,993,74,1
"85","Male",751,777,26,1
"86","Male",906,966,60,1
"87","Male",835,907,72,1
"88","Male",946,1031,85,1
"89","Male",759,781,22,1
"90","Male",909,914,5,0
"91","Male",962,998,36,1
"92","Male",984,1022,38,1
"93","Male",891,932,41,1
"94","Male",835,898,63,1
"95","Male",1039,1060,21,1
"96","Male",1010,1044,34,1
"97","Female",1042,1172,130,1
"98","Female",921,1040,119,1
"99","Female",885,1003,118,1
"100","Female",901,1018,117,1
"101","Female",808,932,124,1
"102","Female",915,1004,89,1
"103","Female",901,1023,122,1
"104","Female",852,908,56,1
"105","Female",828,868,40,1
"106","Female",968,990,22,1
"107","Female",936,1033,97,1
"108","Female",977,1056,79,1
"109","Female",929,999,70,1
"110","Female",936,1064,128,1
"111","Female",1016,1122,106,1
"112","Female",910,1020,110,1
"113","Female",1140,1200,60,1
"114","Female",1015,1056,41,1
"115","Female",850,940,90,1
"116","Female",895,996,101,1
"117","Female",854,969,115,1
"118","Female",957,1089,132,1
"119","Female",1013,1115,102,1
"120","Female",1073,1192,119,1
"121","Female",976,1085,109,1
"122","Female",872,976,104,1
"123","Female",1027,1142,115,1
"124","Female",1071,1200,129,1
"125","Female",919,1017,98,1
"126","Female",894,1006,112,1
"127","Female",885,1012,127,1
"128","Female",889,1000,111,1
"129","Female",887,1012,125,1
"130","Female",920,1040,120,1
"131","Female",1015,1024,9,1
"132","Female",942,1070,128,1
"133","Female",924,1014,90,1
"134","Female",883,996,113,1
"135","Female",930,944,14,1
"136","Female",956,1085,129,1
"137","Female",886,994,108,1
"138","Female",987,1097,110,1
"139","Female",883,966,83,1
"140","Female",837,948,111,1
"141","Female",958,1029,71,1
"142","Female",850,963,113,1
"143","Female",890,905,15,1
"144","Female",847,970,123,1
"145","Female",919,1015,96,1
"146","Female",748,804,56,1
"147","Female",934,1041,107,1
"148","Female",895,991,96,1
"149","Female",874,982,108,1
"150","Female",877,989,112,1
"151","Female",900,959,59,1
"152","Female",957,1084,127,1
"153","Female",1013,1131,118,1
"154","Female",967,1068,101,1
"155","Female",904,919,15,0
"156","Female",829,848,19,0
"157","Female",842,979,137,0
"158","Female",802,876,74,0
"159","Female",840,938,98,0
"160","Female",792,929,137,0
"161","Female",837,848,11,0
"162","Female",941,1006,65,0
"163","Female",746,804,58,0
"164","Female",834,932,98,0
"165","Female",865,932,67,0
"166","Female",828,965,137,0
"167","Female",894,1011,117,0
"168","Female",874,1011,137,0
"169","Female",917,1054,137,0
"170","Female",993,1028,35,0
"171","Female",918,1055,137,0
"172","Female",818,955,137,0
"173","Female",984,1019,35,0
"174","Female",1002,1010,8,0
"175","Female",857,994,137,0
"176","Female",827,836,9,0
"177","Female",883,1020,137,0
"178","Female",1008,1042,34,0
"179","Female",954,1091,137,0
"180","Female",905,1042,137,0
"181","Female",838,975,137,0
"182","Female",934,946,12,0
"183","Female",872,940,68,0
"184","Female",918,922,4,0
"185","Female",844,981,137,0
"186","Female",805,928,123,0
"187","Female",922,1059,137,0
"188","Female",821,958,137,0
"189","Female",838,975,137,0
"190","Female",934,961,27,0
"191","Female",886,1023,137,0
"192","Female",934,1023,89,0
"193","Female",878,1010,132,0
"194","Female",935,1072,137,0
"195","Female",799,825,26,0
"196","Female",849,952,103,0
"197","Female",920,953,33,0
"198","Female",948,998,50,1
"199","Female",968,1105,137,0
"200","Female",908,996,88,0
"201","Female",828,965,137,0
"202","Female",897,1034,137,0
"203","Female",823,938,115,0
"204","Female",950,1008,58,0
"205","Female",1049,1186,137,0
"206","Female",878,1015,137,0
"207","Female",854,991,137,0
"208","Female",877,1014,137,0
"209","Female",820,955,135,0
"210","Female",899,1036,137,0
"211","Female",855,893,38,0
"212","Female",827,964,137,0
"213","Female",925,960,35,0
"214","Female",900,1037,137,0
"215","Female",935,948,13,0
"216","Female",1005,1053,48,0
"217","Female",855,992,137,0
"218","Female",920,992,72,0
"219","Female",810,895,85,0
"220","Female",792,857,65,0
"221","Female",882,1019,137,0
"222","Female",934,1071,137,0
"223","Female",910,1047,137,0
"224","Female",865,973,110,0
"225","Female",899,1036,137,0
"226","Female",982,1119,137,0
"227","Female",856,993,137,0
"228","Female",961,963,2,0
"229","Female",893,1030,137,0
"230","Female",861,998,137,0
"231","Female",829,932,103,0
"232","Female",882,1019,137,0
"233","Female",875,1012,137,0
"234","Female",833,970,137,0
"235","Female",972,1013,41,0
"236","Female",807,944,137,0
"237","Female",924,959,35,0
"238","Female",845,982,137,0
"239","Female",840,977,137,0
"240","Female",867,1004,137,0
"241","Female",881,913,32,0
"242","Female",901,917,16,0
"243","Female",944,947,3,0
"244","Female",821,824,3,0
"245","Female",811,898,87,0
"246","Female",1007,1014,7,0
"247","Female",912,1049,137,0
"248","Female",802,939,137,0
"249","Female",928,1065,137,0
"250","Female",911,938,27,0
"251","Female",847,899,52,0
"252","Female",1035,1172,137,0
"253","Female",893,973,80,0
"254","Female",922,971,49,0
"255","Female",977,985,8,0
"256","Female",941,944,3,0
"257","Female",869,1006,137,0
"258","Female",885,955,70,0
"259","Female",859,996,137,0
"260","Female",948,1085,137,0
"261","Female",890,1005,115,0
"262","Female",887,891,4,0
"263","Female",968,1105,137,0
"264","Female",927,989,62,0
"265","Female",997,1134,137,0
"266","Female",846,983,137,0
"267","Female",831,861,30,0
"268","Female",842,979,137,0
"269","Female",768,905,137,0
"270","Female",896,1033,137,0
"271","Female",894,1014,120,0
"272","Female",885,1022,137,0
"273","Female",822,959,137,0
"274","Female",927,954,27,0
"275","Female",897,904,7,0
"276","Female",848,985,137,0
"277","Female",912,1001,89,0
"278","Female",863,1000,137,0
"279","Female",813,950,137,0
"280","Female",802,939,137,0
"281","Female",956,1061,105,0
"282","Female",822,945,123,0
"283","Female",934,993,59,0
"284","Female",1026,1054,28,0
"285","Female",981,1114,133,0
"286","Female",934,1071,137,0
"287","Female",836,927,91,0
"288","Female",760,897,137,0
"289","Female",820,957,137,0
"290","Female",907,1044,137,0
"291","Female",979,1016,37,0
"292","Female",894,1031,137,0
"293","Female",852,989,137,0
"294","Female",948,971,23,0
"295","Female",813,950,137,0
"296","Female",902,1024,122,0
"297","Female",913,1050,137,0
"298","Female",810,812,2,0
"299","Female",841,978,137,0
"300","Female",875,1012,137,0
"301","Female",841,927,86,0
"302","Female",948,1012,64,0
"303","Female",859,995,136,1
"304","Female",820,957,137,0
"305","Female",860,997,137,0
"306","Female",917,948,31,0
"307","Female",936,1073,137,0
"308","Female",950,986,36,0
"309","Female",1013,1031,18,0
"310","Female",847,984,137,0
"311","Female",777,914,137,0
"312","Female",960,988,28,0
"313","Female",920,1057,137,0
"314","Female",935,1051,116,0
"315","Female",933,979,46,0
"316","Female",933,985,52,0
"317","Female",797,934,137,0
"318","Female",733,870,137,0
"319","Female",866,953,87,0
"320","Female",870,930,60,0
"321","Female",795,875,80,0
"322","Female",905,1005,100,1
"323","Female",796,891,95,0
"324","Female",965,1102,137,0
"325","Female",775,912,137,0
"326","Female",942,977,35,0
"327","Female",895,926,31,0
"328","Female",981,1038,57,0
"329","Female",991,1006,15,0
"330","Female",894,918,24,0
"331","Female",886,943,57,0
"332","Female",871,924,53,0
"333","Female",839,976,137,0
"334","Female",839,976,137,0
"335","Female",858,995,137,0
"336","Female",830,967,137,0
"337","Female",868,1005,137,0
"338","Female",831,925,94,0
"339","Female",783,888,105,0
"340","Female",925,1062,137,0
"341","Female",898,1035,137,0
"342","Female",910,1009,99,0
"343","Female",958,1008,50,0
"344","Female",866,1003,137,0
"345","Female",851,988,137,0
"346","Female",906,1043,137,0
"347","Female",882,1019,137,0
"348","Female",815,952,137,0
"349","Female",972,1083,111,1
"350","Female",973,985,12,0
"351","Female",1010,1147,137,0
"352","Female",1070,1207,137,0
"353","Female",895,1032,137,0
"354","Female",818,860,42,0
"355","Female",864,1001,137,0
"356","Female",857,994,137,0
"357","Female",1028,1063,35,0
"358","Female",892,1029,137,0
"359","Female",769,906,137,0
"360","Female",883,1020,137,0
"361","Female",972,1109,137,0
"362","Female",965,1088,123,0
"363","Female",925,961,36,0
"364","Female",814,872,58,0
"365","Female",805,942,137,0
"366","Female",992,1010,18,0
"367","Female",943,1080,137,0
"368","Female",951,958,7,0
"369","Female",926,987,61,0
"370","Female",954,962,8,0
"371","Female",900,912,12,0
"372","Female",762,854,92,0
"373","Female",823,882,59,0
"374","Female",978,1010,32,1
"375","Female",966,1027,61,1
"376","Female",912,916,4,0
"377","Female",823,829,6,0
"378","Female",909,933,24,0
"379","Female",967,1041,74,1
"380","Female",851,905,54,1
"381","Female",843,861,18,1
"382","Female",963,1021,58,1
"383","Female",888,919,31,1
"384","Female",794,798,4,0
"385","Female",905,928,23,1
"386","Female",1039,1086,47,1
"387","Female",901,923,22,1
"388","Female",823,830,7,1
"389","Female",809,822,13,1
"390","Female",887,905,18,0
"391","Female",859,926,67,1
"392","Female",1004,1015,11,0
"393","Female",919,931,12,1
"394","Female",958,1041,83,1
"395","Female",1003,1093,90,1
"396","Female",871,944,73,1
"397","Female",864,873,9,1
"398","Female",996,1073,77,1
"399","Female",1034,1068,34,1
"400","Female",873,897,24,1
"401","Female",984,1047,63,1
"402","Female",943,1011,68,1
"403","Female",1007,1019,12,1
"404","Female",935,1006,71,1
"405","Female",929,996,67,1
"406","Female",939,978,39,1
"407","Female",772,840,68,1
"408","Female",871,912,41,0
"409","Female",873,954,81,1
"410","Female",981,1018,37,1
"411","Female",894,927,33,0
"412","Female",994,1040,46,1
"413","Female",976,995,19,1
"414","Female",847,883,36,1
"415","Female",859,941,82,1
"416","Female",933,990,57,1
"417","Female",861,934,73,1
"418","Female",886,908,22,1
"419","Female",943,986,43,1
"420","Female",931,969,38,1
"421","Female",948,1019,71,1
"422","Female",955,992,37,1
"423","Female",1004,1023,19,1
"424","Female",828,895,67,1
"425","Female",835,845,10,1
"426","Female",868,870,2,0
"427","Female",988,1074,86,1
"428","Female",861,930,69,1
"429","Female",959,976,17,0
"430","Female",871,874,3,0
"431","Female",847,892,45,0
"432","Female",874,885,11,1
"433","Female",992,1044,52,1
"434","Female",1027,1072,45,1
"435","Female",857,901,44,1
"436","Female",994,1013,19,1
"437","Female",1041,1043,2,1
"438","Female",900,926,26,0
"439","Female",1096,1152,56,1
"440","Female",930,936,6,1
"441","Female",943,994,51,1
"442","Female",1024,1063,39,1
"443","Female",802,821,19,0
"444","Female",811,819,8,0
"445","Female",927,1001,74,1
"446","Female",967,975,8,1
"447","Female",943,982,39,1
"448","Female",840,905,65,0
"449","Female",979,1040,61,1
"450","Female",921,926,5,0
"451","Female",986,1030,44,1
"452","Female",1039,1132,93,1
"453","Female",968,990,22,1
"454","Female",955,990,35,1
"455","Female",837,911,74,1
"456","Female",861,915,54,1
"457","Female",967,983,16,1
